------!---
-!---####-
###-------
-------R--
-!---####
###-------
-----T-!--
---#######
-@----R---
##########
