----------
-----####-
-!-----R--
###--####-
-!-----M-!
###--#####
----------
---#####-#
-@----R-!-
##########
