----------
--------!-
------####
-R--------
#####---!-
------####
-------R--
---#######
-@--------
##########
