----------
----!-----
---!-!----
--!---!---
-#######--
----------
-------!--
-----#####
-R-----@--
##########
