----------
-----T-R-!
-----#####
!-R-------
####------
------R---
---######-
----------
-@-----R--
##########
