----------
----------
----------
----------
-!--------
####------
-------!--
----######
-@-----R--
##########
